....#.....
..........
..........
........#.
........#.
..#.......