....#...........
.............#..
.............#..
........#.......
........#.....#.
..#............#
................
................