..........
...####...
..........
........#.
........#.
..........